# # # # # # # # # # # # # # # # # #
# p . * . . . . ? # . . . * . # ? #
# . . # # # . # # # * # . # . . . #
# # . # ? # . * . x . # . # * # # #
# . . . . # # # . . . # ? # . . ? #
# * # # # # ? # # # # # # # . # # #
# . . . # . . # . . . * . . . . . #
# # # . # . # # . # # # * # # # . #
# ? . . # . * ? . . ? # . . ? # b #
# # # # # # # # # # # # # # # # # #